NO ./imgs/norte.png
SO ./imgs/sur.png
WE ./imgs/oeste.png
EA ./imgs/este.png
F 255,100,0
C 255,30,20
111111111
101000011
101000011
101000011
100000011
100001011
100000N11
111111111