NO ./imgs/norte.png
SO ./imgs/sur.png
WE ./imgs/oeste.png
EA ./imgs/este.png
F 255,100,0
C 255,30,20
1111111
10100001
10100001
10100001
10000001
10000101
100000N1
11111111