
C 51,218,255
NO img/MARBFAC2.xpm
F 196,37,196
SO img/MARBFACE.xpm
EA img/SKULWAL3.xpm
WE img/SKULWALL.xpm
  
   1
   11
 1111111        111111111
110000011      10000000111
100000001     1000000000001
 1000001     100000000000001
  11011      1000000000000001
   101        1000000100000001
   101         100001 10000001
   101111111111100000100000001
   10000000000000000000000001
   1011111111111000000000001
   101         100000000001
   101        100000000001           
  11011      100000000001
 1000001     1000000N0001
100000001     10000000001
110000011      1000000001
 1111111        111111111
  11111          1111111
   111            1111