C 51,218,255
NO imgs/norte.png
F 196,37,196
SO ./imgs/sur.png
EA ./imgs/este.png
WE ./imgs/oeste.png

   1
   11
 1111111        111111111
110000011      10000000111
100000001     1000000000001
 1000001     100000000000001
  11011      1000000000000001
   101        1000000100000001
   101         100001 10000001
   101111111111100000100000001
   10000000000000000000000001
   1011111111111000000000001
   101         100000000001
   101        100000000001
  11011      100000000001
 1000001     1000000N0001
100000001     10000000N01
110000011      1000000001
 1111111        111111111
  11111          1111
   111